NO assets/normal_stone.xpm
SO assets/slime_stone.xpm
WE assets/wood_planks.xpm
EA assets/blue_blocks.xpm

F 200,100,0
C 225,30,0

111111111111111111111111111111111111111111111111111111111
100000000000000000000000000000000000000000000000000000001
100000000000000000000000000000000000000000000000000000001
100000000000000000000000000000000000000000000000000000001
100000000000000000000000000000000000000000000000000000001
100000000000000000000000000000000000000000000000000000001
100000000000000000000000000000000000000000000000000000001
100000000000000000000000111111000000000000000000000000001
100000000000000000000000000000000000000000000000000000001
100000000000000000000000100N00100000000000000000000000001
100000000000000000000000000000000000000000000000000000001
100000000000000000000000100000100000000000000000000000001
100000000000000000000000000000000000000000000000000000001
100000000000000000000000000000000000000000000000000000001
100000000000000000000000000000000000000000000000000000001
100000000000000000000000000000000000000000000000000000001
100000000000000000000000000000000000000000000000000000001
100000000000000000000000000000000000000000000000000000001
100000000000000000000000000000000000000000000000000000001
100000000000000000000000000000000000000000000000000000001
100000000000000000000000000000000000000000000000000000001
100000000000000000000000000000000000000000000000000000001
100000000000000000000000000000000000000000000000000000001
100000000000000000000000000000000000000000000000000000001
100100100100100100100100100100100100100100100100100100101
111111111111111111111111111111111111111111111111111111111