NO assets/normal_stone.xpm
SO assets/slime_stone.xpm

F 0,255,0

1111111111111111111111111111111
10000000000000S0000000000000001
1001000100010001000100010001001
1000010001000100010001000100001
1001000100010001000100010001001
1000010001000100010001000100001
1111111111111111111111111111111

1111111111111111111111111111111
1001000100010001000100010001001
1000010001000100010001000100001
1001000100010001000100010001001
1000010001000100010001000100001
1001000100010001000100010001001
1000010001000100010001000100001
1001000100010001000100010001001
1111111111111111111111111111111

WE assets/wood_planks.xpm
C 0,0,255
EA assets/bricks_n_flag.xpm