NO assets/normal_stone.xpm
SO assets/slime_stone.xpm
WE assets/wood_planks.xpm
EA assets/blue_blocks.xpm

F 20abc0,100,0
C 22cba5,30,0

11111
10001
10S01
10001
11111